100
100
0000000000000000000000000000000000000000000000000000000000000000000000000000000000000000000000000000
0000000000000000000000000000000000000000000000000000000000000000000000000000000000000000000000000000
0000000000000000000000000000000000000000000000000000000000000000000000000000000000000000000000000000
0000000000000000000000000000000000000000000000000000000000000000000000000000000000000000000000000000
0000000000000000000000000000000000000000000000000000000000000000000000000000000000000000000000000000
0000000000000000000000000000000000000000000000000000000000000000000000000000000000000000000000000000
0000000000000000000000000000000000000000000000000000000000000000000000000000000000000000000000000000
0000000000000000000000000000000000000000000000000000000000000000000000000000000000000000000000000000
0000000000000000000000000000000000000000000000000000000000000000000000000000000000000000000000000000
0000000000000000000000000000000000000000000000000000000000000000000000000000000000000000000000000000
0000000000000000000000000000000000000000000000000000000000000000000000000000000000000000000000000000
0000000000000000000000000000000000000000000000000000000000000000000000000000000000000000000000000000
0000000000000000000000000000000000000000000000000000000000000000000000000000000000000000000000000000
0000000000000000000000000000000000000000000000000000000000000000000000000000000000000000000000000000
0000000000000000000000000000000000000000000000000000000000000000000000000000000000000000000000000000
0000000000000000000000000000000000000000000000000000000000000000000000000000000000000000000000000000
0000000000000000000000000000000000000000000000000000000000000000000000000000000000000000000000000000
0000000000000000000000000000000000000000000000000000000000000000000000000000000000000000000000000000
0000000000000000000000000000000000000000000000000000000000000000000000000000000000000000000000000000
0000000000000000000000000000000000000000000000000000000000000000000000000000000000000000000000000000
0000000000000000000000000000000000000000000000000000000000000000000000000000000000000000000000000000
0000000000000000000000000000000000000000000000000000000000000000000000000000000000000000000000000000
0000000000000000000000000000000000000000000000000000000000000000000000000000000000000000000000000000
0000000000000000000000000000000000000000000000000000000000000000000000000000000000000000000000000000
0000000000000000000000000000000000000000000000000000000000000000000000000000000000000000000000000000
0000000000000000000000000000000000000000000000000000000000000000000000000000000000000000000000000000
0000000000000000000000000000000000000000000000000000000000000000000000000000000000000000000000000000
0000000000000000000000000000000000000000000000000000000000000000000000000000000000000000000000000000
0000000000000000000000000000000000000000000000000000000000000000000000000000000000000000000000000000
0000000000000000000000000000000000000000000000000000000000000000000000000000000000000000000000000000
0000000000000000000000000000000000000000000000000000000000000000000000000000000000000000000000000000
0000000000000000000000000000000000000000000000000000000000000000000000000000000000000000000000000000
0000000000000000000000000000000000000000000000000000000000000000000000000000000000000000000000000000
0000000000000000000000000000000000000000000000000000000000000000000000000000000000000000000000000000
0000000000000000000000000000000000000000000000000000000000000000000000000000000000000000000000000000
0000000000SSSSSSSSSSSSSSSSSSS00000000000000000000000000000000000000000000000000000000000000000000000
0000000000SSSSSSSSSSSSSSSSSS000000000000000000000000000000000000000000000000000000000000000000000000
00000000000SSSSSSSSSSSSSSSSSSSSSSSSS0000000000000000000000000000000000000000000000000000000000000000
0000000000SSSSSSSSSSSSSSSSSSSSSSSSSSS000000000000000000000000000000000000000000000000000000000000000
000000000SSSSSSSSSSSSSSSSS00000000000000000000000000000000000000000000000000000000000000000000000000
0000000000000000000000000000000000000000000000000000000000000000000000000000000000000000000000000000
0000000000000000000000000000000000000000000000000000000000000000000000000000000000000000000000000000
0000000000000000000000000000000000000000000000000000000000000000000000000000000000000000000000000000
0000000000000000000000000000000000000000000000000000000000000000000000000000000000000000000000000000
0000000000000000000000000000000000000000000000000000000000000000000000000000000000000000000000000000
0000000000000000000000000000000000FFFFFFFFFFFFFFFFFFFFFFFFFFFFFFFFFFFFFFFFFFF00000000000000000000000
00000000000000000000000000000000000FFFFFFFFFFFFFFFFFFFFFFFFFFF00000000000000000000000000000000000000
00000000000000000000000000000FFFFFFFFFFFFFFFFFFFFFFFFFFFFFFFFFFFFFFFFF000000000000000000000000000000
00000000000000000000000000000000FFFFFFFFFFFFFFFFFFFFFFFFFFFFFFFFFFFFFFFF0000000000000000000000000000
00000000000000000000000000000000000000000FFFFFFFFFFFFFFFFFFFFFFFFFFFFFF00000000000000000000000000000
0000000000000000000000000000000000000000000FFFFFFFFFFFFFFF000000000000000000000000000000000000000000
00000000000000000000000000000000000000000000FFFFFFFFFFFF00000000000000000000000000000000000000000000
000000000000000000000000000000000000000000000FFFFFFFFFFF00000000000000000000000000000000000000000000
0000000000000000000000000000000000000000000000FFFFFFFFFF00000000000000000000000000000000000000000000
00000000000000000000000000000000000000000000000FFFFFFFFFF0000000000000000000000000000000000000000000
00000000000000000000000000000000000000000000000FFFFFFF0000000000000000000000000000000000000000000000
000000000000000000000000000000000000000000000000FFFF000000000000000000000000000000000000000000000000
0000000000000000000000000000000000000000000000000000000000000000000000000000000000000000000000000000
0000000000000000000000000000000000000000000000000000000000000000000000000000000000000000000000000000
0000000000000000000000000000000000000000000000000000000000000000000000000000000000000000000000000000
0000000000000000000000000000000000000000000000000000000000000000000000000000000000000000000000000000
0000000000000000000000000000000000000000000000000000000000000000000000000000000000000000000000000000
0000000000000000000000000000000000000000000000000000000000000000000000000000000000000000000000000000
0000000000000000000000000000000000000000000000000000000000000000000000000000000000000000000000000000
0000000000000000000000000000000000000000000000000000000000000000000000000000000000000000000000000000
0000000000000000000000000000000000000000000000000000000000000000000000000000000000000000000000000000
00000000000000000000000000000000000000000000SSSSSSSSSSSSSSSSSSSSS00000000000000000000000000000000000
00000000000000000000000000000000000000000000SSSSSSSSSSSSSSSSSSS0000000000000000000000000000000000000
00000000000000000000000000000000000000000000SSSSSSSSSSSSSSSSSSSSS00000000000000000000000000000000000
00000000000000000000000000000000000000000000SSSSSSSSSSSSSSSSSSSSS00000000000000000000000000000000000
000000000000000000000000000000000000000000000SSSSSSSSSSSSSSSSSSS000000000000000000000000000000000000
00000000000000000000000000000000000000000000SSSSSSSSSSSSSSSSSSSSSS0000000000000000000000000000000000
00000000000000000000000000000000000000000000SSSSSSSSSSSSSSSSSSSS000000000000000000000000000000000000
000000000000000000000000000000000000000000000SSSSSSSSSSSSSSSSSSS000000000000000000000000000000000000
00000000000000000000000000000000000000000000SSSSSSSSSSSSSSSSSSSSS00000000000000000000000000000000000
0000000000000000000000000000000000000000000000SSSSSSSSSSSSSSSSSS000000000000000000000000000000000000
000000000000000000000000000000000000000000000SSSSSSSSSSSSSSS0000000000000000000000000000000000000000
00000000000000000000000000000000000000000000SSSSSSSSSSSSSSSSS000000000000000000000000000000000000000
00000000000000000000000000000000000000000000SSSSSSSSSSSSSSSSSSSSSSS000000000000000000000000000000000
0000000000000000000000000000000000000000000SSSSSSSSSSSSSSSSSSSS0000000000000000000000000000000000000
0000000000000000000000000000000000SSSSSSSSSSSSSSSSSSSSSSSSSSSSSSSSSSSSSSSSSS000000000000000000000000
000000000000000000000000000SSSSSSSSSSSSSSSSSSSSSSSSSSSSSSSSSSSSSSSSSSSSSSSS0000000000000000000000000
0000000000000000000000000000000000SSSSSSSSSSSSSSSSSSSSSSSSSSSSSSSSSSSSSSSSSSSS0000000000000000000000
00000000000000000000000SSSSSSSSSSSSSSSSSSSSSSSSSSSSSSSSSSSSSSSSSSSSSSSSSSSSSSSSSSSSSS000000000000000
0000000000000000000000000000SSSSSSSSSSSSSSSSSSSSSSSSSSSSSSSSSSSSSSSSSSSSSSSSSSS000000000000000000000
00000000000000000000000000000SSSSSSSSSSSSSSSSSSSSSSSSSSSSSSSSSSSSSSSSSSSSS00000000000000000000000000
00000000000000000000000000000000000SSSSSSSSSSSSSSSSSSSSSSSSSSSSSSSSSSSSSSSSSS00000000000000000000000
00000000000000000000000000SSSSSSSSSSSSSSSSSSSSSSSSSSSSSSSSSSSSSSSSSSSSSSSSSS000000000000000000000000
0000000000000000000000000000000000SSSSSSSSSSSSSSSSSSSSSSSSSSSSSSSSSSSSSSSSSSSSSSSSSS0000000000000000
0000000000000000000000000000000000000000000000000000000000000000000000000000000000000000000000000000
0000000000000000000000000000000000000000000000000000000000000000000000000000000000000000000000000000
0000000000000000000000000000000000000000000000000000000000000000000000000000000000000000000000000000
0000000000000000000000000000000000000000000000000000000000000000000000000000000000000000000000000000
0000000000000000000000000000000000000000000000000000000000000000000000000000000000000000000000000000
0000000000000000000000000000000000000000000000000000000000000000000000000000000000000000000000000000
0000000000000000000000000000000000000000000000000000000000000000000000000000000000000000000000000000
0000000000000000000000000000000000000000000000000000000000000000000000000000000000000000000000000000
0000000000000000000000000000000000000000000000000000000000000000000000000000000000000000000000000000
0000000000000000000000000000000000000000000000000000000000000000000000000000000000000000000000000000
0000000000000000000000000000000000000000000000000000000000000000000000000000000000000000000000000000
END